WWWWWWWWWWWWWWWWWWWW
WW     WW    WW    W
W  WW     WWWWW    W
W   WWWW       W   W
W   W  WWWW  WWWW  W
W WWW  WWWW        W
W   W     W W  WW  W
W   W WW  W   WW  WW
W      W   W  W    W
W  W     WW    W   W
W  W WWW WWW W W W W
W@    W   W   W W  W
WWW   W    W  W W  W
W W WW     WW      W
W W  W WWWW   WWW  W
W     W   W     W  W
W   W    W    W    W
W  W   W    W   W  W
W    W      W   W  W
WWWWWWWWWWWWWWWWWWWW